level 4
next_level assets/level_3.map
map
# # # # # # # # # # -1
# S 0 0 0 # 0 # K # -1
# 0 0 # # # 0 # 0 # -1
# 0 0 # 0 0 0 # 0 # -1
# 0 0 E 0 # 0 0 0 # -1
# 0 # # # # # # # # -1
# 0 0 0 0 # 0 0 H # -1
# 0 0 # 0 # 0 # 0 # -1
# 0 0 # 0 0 0 # 0 D -1
# # # # # # # # # # -2